xxxxxxxxx.xxxxxxxxx
x.......x.x.......x
x.......x.x.......x
x.......x.x.......x
x.................x
x.................x
x.................x
x.................x
x......xxxxx......x
x......x...x......x
x......x...x......x
x......x...x......x
x.................x
x.................x
x.................x
x.................x
x.......x.x.......x
x.......x.x.......x
x.......x.x.......x
xxxxxxxxx.xxxxxxxxx